999999999
940000009
999909999
999000999
990000099
999030999
999909999
999999999
