9999999999999999999999999999999999999999999999999999999999999999999999999999999999999999999999999999
9000000000000000000000000000000000000000000000000000000000000000000000000000000000000000000000000009
9000000000000000000000000000000000000000000000000000000000000000000000000000000000000000000000000009
9000000000000000000000000000000000000000000000000000000000000000000000000000000000000000000000000009
9000000000000000000000000000000000000000000000000000000000000000000000000000000000000000000000000009
9000000000000000000000000000000000000000000000000000000000000000000000000000000000000000000000000009
9000000000000000000000000000000000000000000000000000000000000000000000000000000000000000000000000009
9000000000000000000000000000000000000000000000000000000000000000000000000000000000000000000000000009
9000000000000000000000000990000000000000000000000000000000000000000000000000000000000000000000000009
9000000000000000000000009900000000000000000000000000000000000000999999000000000000000000000000000009
9000000000000000000000990000000000000000000000000000000000000000000009000000000000000000000000000009
9000000000000000000009900000000000000000000000009090909000000000000009990000000000000000000000000009
9000000000000000000990000000000000000000000000000909090000000000000000099999900000000000000000000009
9000000000000000000900000000000000000000000000000000000000000000000000000000000000000000000000000009
9000000000000000000000000000000000000000000000000000000000000000000000000000000000000000000000000009
9000000000000000000000000000000000000000000000000000000000000000000000000000000000000000000000000009
9000000000000000000000000000000000000000000000000000000000000000000000000000000000000000000000000009
9000000000000000000000000000000000000000000000000000000000000000000000000000000000000000000000000009
9000000000000000000000000000000000000000000000000000000000000000000000000000000000000000000000000009
9000000000000000000000000000000000000000000000000000000090000000000000000000000000000000000000000009
9000000000000900000000000000000000000000000000000000000009990000000000000000000000000000000000000009
9000000000090000000000000000000000000000000990000000000000099900000000000000000000000000000000000009
9000000000900000000099999999990000000000999900000000000000009999000000000000000000000000000000000009
9000000000900000009990000000090000009999900000000000000000000009900000000000000000000000000000000009
9000000000900040000000000000390000000000000000000000000000000000000000000000000000000000000000000009
9000000000090000009990000000090000009999900000000000000000000000000000000000000000000000000000000009
9000000000009000000099999999990000000000099900000000000000000000000000000000000000000009000000000009
9000000000000000000000000000000000000000000990000000000000000000000000000000000000000009999000000009
9000000000000000000000000000000000000000000000000900999000000000000000000000000000000000009000000009
9000000000000000000000000000000000000000000000000990009990000000000099000000000000000000009000000009
9000000000000000000000000000000000000000000000000999909099900000000990000000000000000000009000000009
9000000000000000000000000000000000000000000000009900000000999000009900000000000000000000009000000009
9000000000000000000000000000000000000000009000090900000000009900099000000000000000000000009000000009
9000000000000000000000000000000000000000009000900900000000000000000000000000000000000000000000000009
9000000000000000000000000000000000000000000999000900000000000000000000000000000000000000000000000009
9000000000000000000000000000000000000000000000000000000000000000000000000000000000000000000000000009
9000000000000999999999999999999999999999999999999999999999999999999999999999999999999990000000000009
9000000000000000000000000000000000000000000000000000000000000000000000000000000000000000000000000009
9000000000000000000000000000000000000000000000000000000000000000000000000000000000000000000000000009
9000000000000000000000000000000000000000000000000000000000000000000000000000000000000000000000000009
9000000000000000000000000000000000000000000000000000000000000000000000000000000000000000000000000009
9000000000000000000000000000000000000000000000000000000000000000000000000000000000000000000000000009
9000000000000000000000000000000000000000000000000000000000000000000000000000000000000000000000000009
9000000000000000000000000000000000000000000000000000000000000000000000000000000000000000000000000009
9000000000000000000000000000000000000000000000000000000000000000000000000000000000000000000000000009
9000000000000000000000000000000000000000000000000000000000000000000000000000000000000000000000000009
9000000000000000000000000000000000000000000000000000000000000000000000000000000000000000000000000009
9000000000000000000000000000000000000000000000000000000000000000000000000000000000000000000000000009
9000000000000000000000000000000000000000000000000000000000000000000000000000000000000000000000000009
9999999999999999999999999999999999999999999999999999999999999999999999999999999999999999999999999999
