99999999999999999999999999999999999999999999999999999999999999999999999999999999
90003000000000000000000000000000000000000000000000000000000000000000000000000009
99999990999999999900000999999999999909999999999999999000099999999999999990999999
90000000000000009009000000000000000009000000009000000000000000009000900090900009
90000000000000900009009999999009999009999990909999999999999999099090009000009009
90009999900000999909000900900000000099999900909000000000000090009099999999999999
90000999900000000909000900990099909000000000909090000000000090009000000000000009
90000009900099900909000900090090009999990000909099999999900090009999999999009999
90000000900099900909999990000090009000099990909090000000000090000000000009009009
90000000000090000009900990099999909009990000009099999000000099999999999909099009
90000000000090000000000000000000009000000000909009000000090000900000000009090099
99900999999999900000099999990999999999990099999009000090090000900000990000000999
90000099999990009000090000000000009900000000000009000090090000999000999990000009
90000000000090009990000099999999000009999990999999990099999999900000999990000009
99999999990000009990090009000009000909000000000000000000900000000000999999000009
90099000090099909900090000000009009909000009900999999990900900900000099900000009
90009000090000009000099999990999999909999999999900090000900900900000000000000009
90099990099999999000000900000000009909000000000000090000900900999999999900999999
90009900090000000000000909999999900009000099999900090000999900090000000000990009
90099900090099999999900009000000999999999999900900090090000000090999999900900909
90000900090090000000009009000000000009000009900900090090099900090000000900900999
90900000090090000999999999099990009009000000000900099999990000090900990900900009
90999990000099000000099000090099999009999099009099999990000999909900990900999009
90000900090090009990000000090000000000000009000000000000090000090000994900000009
99999999999999999999999999999999999999999999999999999999999999999999999999999999
